###########
#---------#
#-$-$@$-$-#
#--$-$-$--#
#-$-$-$-$-#
#--$-$-$--#
#####$##$##
-#.....#-# 
-#....*#-# 
-#...*---# 
-#....-### 
-########  